0
1
2
3
4
5
6
7
8 38 98 99
9 73 100 101 102
10 103 104 105 106 107 108 109
11 110 111 112 113
12 114 115
13
14
15 69
16
17
18
19
20
21
22
23
24
25
26 24 25 26 94 95 96
27 24 25 26 97
28 24 25 26 128 129 130 131 132
29 24 25 26 133 134 135 136 137 138 139 140 141 142
30 143 144
31
32
33 40
34 69
35
36
37
38 41
39 19 23 29 30 57 58 59 60 41
40 19 20 23 31 61 65 41
41 20 23 32 33 34 41 42 31
42 20 21 22 23 33 42 62 63 41
43 21 22 42
44 21 22 145 42
45 21 22 24 25 26 27 43 93 42
46 24 25 26 27 35 36 37 43
47 24 25 26 27 35 36 37 64 43
48 1 2 3 4 5 6 7 8 24 25 26 27 44 43 35 36 37
49 9 10 11 12 13 14 45 66
50 28 67 45 66
51 28 74 75 76 77 78 79 80 81 82 83 84 85 86 87 88 89 90 91 45
52 28 39 92 45
53 15 16 17 18 28 46 68 69 70
54 46
55 146 46
56 46
57
58
59
60
61
62
63
64
65
66
67
68
69
70 47 48 49 50 51 52 53 54 55 56 71
71 47 48 49 50 51 52 53 54 55 56 116 117 118 119 120 121 122 123 124 125 126 127
72 47 48 49 50 51 52 53 54 55 56 72
73 47 48 49 50 51 52 53 54 55 56
74
75
76
77
78
79
80
81
82
83
84
85
86
87
88
89 47 48 49 50 51 52 53 54 55 56
90 47 48 49 50 51 52 53 54 55 56
91 47 48 49 50 51 52 53 54 55 56
92 47 48 49 50 51 52 53 54 55 56
93
94
