0 14
1 14 20 21 22 23
2 24 25 26 27 28 89 102 103 104 105 106 107
3 90 91
4 29 30 31 32 33 34
5 35 36 37 38 39 40 41 42 43 44 45 46 47 93 108 109 110 111 112 113
6 48 49 50 55 56 57
7 11 58 59 60 61 62 65 94
8 63 64 66 67 68 69 70 71 95 114 115
9 72 73 74 96 97 116
10 75 76 77 78 98 117 118 119 120 121 122 123 124
11 83 84 85 86 87 99 100
12 12 18 88 125 126 127
13 1 2 3 4 5 6 7 8 9 10 13 15
14 19
15
16 128
17
18 14
19 14
20
21
22 92
23
24 51 52 53 54
25
26
27
28 79 80 81 82
29 101
30 15 16
31 16 17
32 17
33 17
34 17
35 17
